###############################
#p   4                        #
# # # # # # # # # # # # # # # #
#                             #
# # # # # # # # # # # # # # #*#
#                             #
# # # # # # # # # # # # # # # #
#                             #
# # # # # # # # # # # # # # # #
#                             #
# # # # # # # # # # # # # # # #
#                             #
###############################

###############################
#p     s* *    *   *  * * *   #
# # # #*# # #*#*# # # #*#*#*# #
#  x*     b**  *      *   * * #
# # # # # #*# # #*#*# # # # #*#
#f     3   x **  *  *         #
# # # # # # # # # #*# #*# # # #
#*  *      *  *      *        #
# # # # #*# # # #*#*# # # # # #
#*    **  *       *           #
# #*# # # # # # #*# # # # # # #
#           *   *  *          #
###############################